 ##########
 #.$   > M#
 #      $ #
##  U  M  #
# <    ^  #
#$  M $  @# 
###########