#####
# @ #
#   #
#$$$##
# $  #
#  $.#
######