 ###########
 # $      .#
 #   ^M>  $#
##  MU$UM  #
#          #
#$  M    @ #
###########