  ######
  # ..@#
  # $$ #
  ## ###
   # #
   # #
#### #
#    ##
# #   #
#.  # #
###.  #
  #####