  ####
 ##  #
##@$ ##
# $$  #
#     #
### . #
  #####