########
####  $#
# .$  @#
#$     #
#####  #
    ####