 ####
##  ###
# $   #
#.$$$@#
#   ###
##  #
 ####