#######
#  * .#
#     #
## # ##
 #$@$#
 #   #
 #####