#######
#  .  #
#  $  #
# $ $ #
#  $  #
#$$ $ #
#  @  #
#######