#######
#     ###
#  @$$  #
#### ## #
  #     #
  #  ####
  #. #
  ####