#####
#   ###
#    .#
# $ # #
##$# $  #
 #@$    #
 #    ##
 #  ###
 ####