##########
#        #
#$##.### #
# # $$ . #
#   @$## #
#####    #
    ######