 ###########
 # $      .#
 #  ^>U  M$#
##  U   M  #
#          #
#$  M    @ #
############