 ############ 
 # $        .#
 # MUMUMUMUM##
##   U       #
#    M       #
#$ < >    @  #
#         < )#
# ( )  ( >   #
##############