####
#  ####
#     #
# $$#@#
#$    $#
#  $  $##
 #####.##