#####
#   ##
#@$$ #
##   #
 ##  #
  ##.#
   ###