      ###
##### #.#
#   ### #
#   $ # #
# $  $  #
# ###@# #
        #
    #####