###### #####
#    ###   #
# $$     #@#
# $ #    #
#.  ########
#####