 ###########
 # $   <  .#
 #MM  >  M$#
##  MU$  > #
# (     <  #
#$  M  > @ #
###########