     ###
######@##
#     $ #
#   #   #
#####$#$#
    #. $#
    #####