  ####
###  ####
#     $ #
# #  #$ #
#.  .#@ #
#########