######
#    #
#$#@ #
# $$ #
# .$ #
#    #
######