####
#  ##
# @ #
#  $#
##$ ###
 # $  #
 #    #
 # .###
 ####