#######
#     #
# # # #
#. $$@#
#   ###
#####