####
# .###
# $$ #
#    #
# @$ #
#   ##
#####