 ###########
 # $   <  .#
 #MM  >  M$#
##  MU$  > #
# (     <  #
#$ @M  >   #
###########