#####
#   #
# @ #
# $$###
##    #
 #   .#
 ######