#####
#@  ##
# $  #
## $ ####
 ###$   #
  #   #.#
  #     #
  #######