 #####
 # @ #
 #   #
###$$#
#    #
# $$ #
###. #
  ####