      #####
      #.  #
      #$  #
      # # #
####### # #
# @ $ $ $ #
# # #   ###
#       #
#########