     #####
     #   ##
          #
 ### ##   #
##. $ $#  #
# $ $ @  ##
# ######.#
#        #
##########