 ############
 # $  M    .#
 #   MUMUMU$#
##  MUM     #
#   M       #
#$  M    @  #
############