 ####
 # .###
 # $$ #
##    #
#  @$ #
#   ###
#####