 ####
##  #
#. $#
#.$ #
#.$ #
#.$ #
#$ $##
#   @#
##   #
 #####